#	id	file_path	transparent_color_r	g	b
[TEXTURES]
5	resource\textures\title.png	230	130	155

#id	link	sizecell	paddingleft	paddingTop	R	G	B(background)
[MAPS]
1	resource\data\World1\world1-scene1_map.txt	11	0	0	156	252	240

[OBJECTS]
# tag	x	y	type	extra_settings per object type
# MARIO
0	4	25	1

4	0	27	11	41	1	0	2	3	2
4	-1	18	11	1	25	0	1	0	3
4	41	26	11	31	2	3	2	6	2
4	76	27	11	23	1	6	2	8	2
4	101	27	11	5	1	9	2	9	2
4	109	27	11	35	1	9	2	13	2
4	147	27	11	36	1	13	2	15	2
4	23	24	11	2	3	2	2	2	2
4	117	25	11	2	2	10	2	10	2
4	121	24	11	2	3	11	2	11	2
4	147	24	11	2	3	13	2	13	2
4	147	7	11	2	14	13	0	13	1
4	151	25	11	2	2	13	2	13	2
4	135	30	11	1	12	12	2	12	3
4	135	41	11	10	1	12	3	13	3
4	145	40	11	2	2	13	3	13	3
4	146	39	11	2	2	13	3	13	3
4	147	38	11	2	2	13	3	13	3
4	148	37	11	2	2	13	3	13	3
4	149	36	11	2	2	13	3	13	3
4	150	35	11	4	2	13	3	13	3
4	153	30	11	1	6	13	2	13	3
4	137	30	11	15	1	12	2	13	2
4	93	12	9	4	1	8	1	8	1
4	98	11	9	13	1	8	1	10	1
4	99	22	11	2	1	9	2	9	2
4	103	26	11	1	1	9	2	9	2
4	104	25	11	1	2	9	2	9	2
4	105	24	11	1	3	9	2	9	2
4	111	26	11	1	1	10	2	10	2
4	110	25	11	1	2	10	2	10	2
4	109	24	11	1	3	9	2	9	2
4	12	23	5	12	26	1	1	2	1	2
4	13	23	5	12	26	1	1	2	1	2
4	15	20	5	12	26	1	1	1	1	1
4	16	20	5	12	27	1	1	1	1	1
4	27	21	5	12	26	1	2	1	2	1
4	43	25	5	12	29	1	3	2	3	2
4	46	23	5	12	26	1	4	2	4	2
4	97	24	5	12	29	1	8	2	8	2
4	95	8	5	13	28	1	8	0	8	0
4	127	26	5	13	26	1	11	2	11	2
4	128	26	5	13	26	1	11	2	11	2
4	129	26	5	13	26	1	11	2	11	2
4	130	26	5	13	26	1	11	2	11	2
4	131	26	5	13	26	1	11	2	11	2
4	132	26	5	13	26	1	12	2	12	2
4	133	26	5	13	26	1	12	2	12	2
4	128	25	5	13	26	1	11	2	11	2
4	129	25	5	13	26	1	11	2	11	2
4	130	25	5	13	26	1	11	2	11	2
4	131	25	5	13	26	1	11	2	11	2
4	132	25	5	13	26	1	12	2	12	2
4	129	24	5	13	26	1	11	2	11	2
4	130	24	5	13	26	1	11	2	11	2
4	131	24	5	13	26	1	11	2	11	2
4	132	24	5	13	30	1	12	2	12	2
4	136	26	5	13	26	1	12	2	12	2
4	137	26	5	13	26	1	12	2	12	2
4	136	25	5	13	26	1	12	2	12	2
4	16	24	9	3	3	1	2	1	2
4	18	22	9	3	5	1	2	1	2
4	26	24	9	5	3	2	2	2	2
4	30	22	9	4	5	2	2	3	2
4	33	20	9	4	7	3	1	3	2
4	34	25	9	6	2	3	2	3	2
4	83	25	9	7	2	7	2	8	2
4	85	23	9	7	4	7	2	8	2
4	87	21	9	7	6	7	1	8	2
4	86	9	9	4	3	7	0	8	1
4	139	24	9	3	3	12	2	12	2
4	141	18	9	3	9	12	1	13	2
1	16	25	20	1	2	1	2
1	35	25	20	3	2	3	2
1	60	24	20	5	2	5	2
1	65	24	20	5	2	5	2
1	68	24	21	6	2	6	2
1	34	23	17	6	3	2	3	2
1	96	25	17	7	8	2	8	2
1	87	21	18	10	7	1	7	1
1	88	21	18	10	8	1	8	1
1	90	19	18	10	8	1	8	1
1	136	23	17	10	12	2	12	2
1	23	24	23	2	2	2	2
1	121	24	24	11	2	11	2
1	117	25	22	10	2	10	2
5	147	5	33	1	2	2	2	136	32	128	30	160	30	0	13	0	13	0
5	151	30	33	2	2	2	-2	151	23	0	0	183	16	0	13	2	13	2
4	175	21	5	37	0	1	15	1	15	1
3	71	22	26	6	2	6	2
3	73	20	26	6	1	6	1
3	75	18	26	6	1	6	1
3	77	16	26	7	1	7	1
3	79	14	26	7	1	7	1
3	87	5	26	7	0	7	0
3	88	5	26	8	0	8	0
3	89	5	26	8	0	8	0
3	97	7	26	8	0	8	0
3	98	7	26	8	0	8	0
3	101	8	26	9	0	9	0
3	102	8	26	9	0	9	0
3	103	8	26	9	0	9	0
3	105	7	26	9	0	9	0
3	106	7	26	9	0	9	0
3	107	7	26	9	0	9	0
3	108	7	26	9	0	9	0
3	112	9	26	10	0	10	0
3	114	8	26	10	0	10	0
3	119	7	26	10	0	10	0
3	120	9	26	10	0	10	0
3	142	32	26	12	2	12	2
3	143	32	26	13	2	13	2
3	141	33	26	12	3	12	3
3	144	33	26	13	3	13	3
3	144	34	26	13	3	13	3
3	142	35	26	12	3	12	3
3	143	35	26	13	3	13	3
3	144	36	26	13	3	13	3
3	141	37	26	12	3	12	3
3	144	37	26	13	3	13	3
3	142	38	26	12	3	12	3
3	143	38	26	13	3	13	3

[SETTINGS]
cam	0	0	183	16	0
time	300
scene	2