[TEXTURES]
5	resource\textures\title.png	230	130	155
[SPRITES]
990001	768	480	911	527	5

[ANIMATIONS]
300100	990001	100

[ANIMATION_SETS]
4	41	300100	0	300100	1

[MAPS]
1	resource\data\World1\world1-scene4_map.txt	11	0	0	156	252	240

[OBJECTS]
0	3	5	1
4	0	7	11	10	5	0	0	0	1
4	120	10	11	8	2	10	0	11	1
4	121	6	11	2	4	11	0	11	0
4	127	0	11	1	10	11	0	11	0
4	137	9	11	2	2	12	0	12	0
4	129	11	11	31	1	11	1	13	1
4	14	7	5	13	26	1	1	0	1	0
4	15	7	5	13	26	1	1	0	1	0
4	16	7	5	13	26	1	1	0	1	0
4	17	7	5	13	26	1	1	0	1	0
4	14	7	5	13	26	1	1	0	1	0
4	15	7	5	13	26	1	1	0	1	0
4	16	7	5	13	26	1	1	0	1	0
4	17	7	5	13	26	1	1	0	1	0
4	24	6	5	13	26	1	2	0	2	0
4	25	6	5	13	26	1	2	0	2	0
4	26	6	5	13	26	1	2	0	2	0
4	27	6	5	13	26	1	2	0	2	0
4	28	6	5	13	26	1	2	0	2	0
4	38	3	5	13	26	1	3	0	3	0
4	39	3	5	13	26	1	3	0	3	0
4	40	3	5	13	28	1	3	0	3	0
4	41	3	5	13	26	1	3	0	3	0
4	40	8	5	13	26	1	3	0	3	0
4	41	8	5	13	26	1	3	0	3	0
4	47	5	5	13	26	1	4	0	4	0
4	47	6	5	13	26	1	4	0	4	0
4	47	7	5	13	26	1	4	0	4	0
4	47	8	5	13	26	1	4	0	4	0
4	48	8	5	13	26	1	4	0	4	0
4	49	8	5	13	26	1	4	0	4	0
4	50	8	5	13	26	1	4	0	4	0
4	54	6	5	13	26	1	4	0	4	0
4	54	7	5	13	26	1	4	0	4	0
4	54	8	5	13	26	1	4	0	4	0
4	54	9	5	13	26	1	4	0	4	0
4	55	9	5	13	26	1	5	0	5	0
4	56	9	5	13	26	1	5	0	5	0
4	59	6	5	13	26	1	5	0	5	0
4	59	7	5	13	26	1	5	0	5	0
4	60	7	5	13	29	1	5	0	5	0
4	60	10	5	13	26	1	5	0	5	0
4	61	10	5	13	26	1	5	0	5	0
4	62	10	5	13	26	1	5	0	5	0
4	63	10	5	13	26	1	5	0	5	0
4	63	7	5	13	49	10	5	0	5	0
4	64	7	5	13	26	1	5	0	5	0
4	65	7	5	13	26	1	5	0	5	0
4	66	7	5	13	26	1	6	0	6	0
4	67	7	5	13	26	1	6	0	6	0
4	73	9	5	13	26	1	6	0	6	0
4	74	9	5	13	26	1	6	0	6	0
4	75	9	5	13	26	1	6	0	6	0
4	76	9	5	13	26	1	6	0	6	0
4	74	4	5	13	26	1	6	0	6	0
4	75	4	5	13	26	1	6	0	6	0
4	76	4	5	13	26	1	6	0	6	0
4	77	4	5	13	26	1	7	0	7	0
4	77	3	5	13	28	1	7	0	7	0
4	79	8	5	13	26	1	7	0	7	0
4	80	8	5	13	26	1	7	0	7	0
4	87	4	5	13	26	1	7	0	7	0
4	88	4	5	13	26	1	8	0	8	0
4	89	4	5	13	26	1	8	0	8	0
4	96	3	5	13	49	10	8	0	8	0
4	96	4	5	13	26	1	8	0	8	0
4	96	8	5	13	26	1	8	0	8	0
4	96	9	5	13	26	1	8	0	8	0
4	96	10	5	13	26	1	8	0	8	0
4	97	10	5	13	26	1	8	0	8	0
4	98	10	5	13	26	1	8	0	8	0
4	99	10	5	13	26	1	9	0	9	0
4	108	3	5	13	26	1	9	0	9	0
4	108	4	5	13	26	1	9	0	9	0
4	108	5	5	13	26	1	9	0	9	0
4	111	8	5	13	26	1	10	0	10	0
4	112	8	5	13	26	1	10	0	10	0
4	113	8	5	13	26	1	10	0	10	0
4	123	8	9	3	2	11	0	11	0
3	21	4	26	1	0	1	0
3	22	4	26	2	0	2	0
3	23	4	26	2	0	2	0
3	26	2	26	2	0	2	0
3	27	2	26	2	0	2	0
3	28	2	26	2	0	2	0
3	48	4	26	4	0	4	0
3	49	4	26	4	0	4	0
3	50	4	26	4	0	4	0
3	53	2	26	4	0	4	0
3	54	2	26	4	0	4	0
3	55	2	26	5	0	5	0
3	83	3	26	7	0	7	0
3	84	3	26	7	0	7	0
3	85	3	26	7	0	7	0
3	94	2	26	8	0	8	0
3	94	3	26	8	0	8	0
3	94	4	26	8	0	8	0
3	94	5	26	8	0	8	0
3	94	6	26	8	0	8	0
3	94	7	26	8	0	8	0
3	94	8	26	8	0	8	0
3	94	9	26	8	0	8	0
3	118	4	26	10	0	10	0
3	119	4	26	10	0	10	0
3	120	4	26	10	0	10	0
4	23	5	5	41	0	0	2	0	2	0
4	37	4	5	41	0	0	3	0	3	0
4	35	7	5	41	0	0	3	0	3	0
4	39	10	5	41	0	0	3	0	3	0
4	47	6	5	41	0	0	4	0	4	0
4	68	9	5	41	0	0	6	0	6	0
4	75	5	5	41	0	0	6	0	6	0
4	86	7	5	41	0	0	7	0	7	0
4	88	6	5	41	0	0	8	0	8	0
4	97	4	5	41	0	0	8	0	8	0
4	111	6	5	41	0	0	10	0	10	0
4	109	9	5	41	0	0	9	0	9	0
4	112	11	5	41	0	0	10	1	10	1
4	153	5	5	37	0	1	13	0	13	0
1	133	9	42	12	0	12	0
1	117	6	17	24	10	0	10	0
1	124	6	17	7	11	0	11	0
1	65	5	17	7	5	0	5	0

#id	x	y	type	4-idPort	5-width	6-height	7-typeIn	8-posX	9-posY	10-leftScene	11-topScene	12-righttScene	13-botScene
5	121	4	33	1	2	2	2	137	7	129	0	160	0	0	11	0	11	0

[SETTINGS]
cam	0	0	129	0	1
time	300
scene	2